................
................
................
................
................
...........AAAAA
................
................
................
P....AAAAAAA....
................
................
................
AAAA...AAAA.....
